10 15
000000000000000
030000000000000
001111000111100
001001000100100
001001111111100
001004000100000
001000000100000
001111121100000
000000000000000
000000000000000