20 20
00000000000000000000
03000000000000000000
00000000000000000000
00000000000000000000
00000000121000000000
00000000101000000000
00000000101000000000
00000000101000000000
00000000101000000000
00000000141000000000
00000000101000000000
00000000101000000000
00000000101000000000
00000000101000000000
00000000111000000000
00000000000000000000
00000000000000000000
00000000000000000000
00000000000000000000
00000000000000000000
