9 12
000000000000
000000000000
001112111100
001000000100
001311114100
001010010100
001110011100
000000000000
000000000000